Topic Size
Accent: Austin Community College
Advance-Titan: University of Wisconsin - Oshkosh
Anchor: Rhode Island College
Arches: Mount Mary College
Arizona Daily Wildcat: University of Arizona
Arka Tech: Arkansas Tech
Arkansas Traveler: University of Arkansas
Austin College Observer: Austin College
Aztec Press: Pima Community College
Badger Herald: University of Wisconsin - Madison
Bagpipe, The: Covenant College
Black and Magenta: Muskingum College
Brock Press: Brock University
Brookhaven Courier: Brookhaven College
Calvin College Chimes: Calvin College
Cameron Collegian: Cameron University
Campus Carrier: Berry College
Campus Echo: North Carolina Central University
Campus Press: University of Colorado at Boulder
Campus Times: University of Rochester
Cardinal Points: SUNY College at Plattsburgh
Cardinal and Cream: Union University
Carson-Newman: Carson-Newman College
Cavalier Daily: University of Virginia
Central Florida Future
Central Florida Future: University of Central Florida
Chicago Maroon: University of Chicago
Chips: Luther College
City College News: Minneapolis Community & Technical College
City Times: San Diego City College
College Heights Herald: Western Kentucky University
College Media Network: Media network college
Collegian: Delta College
Collegiate: Grand Rapids Community College
Colorado Daily: University of Colorado at Boulder
Columbia Daily Spectator: Columbia University
Commonwealth Times: Virginia Commonwealth University
Concordiensis: Union College
Connect2Mason: George Mason University
Cornell Daily Sun
Cornell Daily Sun: Cornell University
Crimson: Florida Technical College
Daily 49er: California State University - Long Beach
Daily Bruin: University of California - Los Angeles
Daily Bruin: University of California-Los Angeles
Daily Californian: University of California - Berkeley
Daily Californian: University of California-Berkeley
Daily Collegian: Pennsylvania State University
Daily Eastern News
Daily Eastern News: Eastern Illinois University
Daily Evergreen: Washington State University
Daily Illini: University of Illinois at Urbana - Champaign
Daily Lobo: University of New Mexico
Daily Mississippian: University of Mississippi
Daily Nebraskan: University of Nebraska-Lincoln
Daily Northwestern
Daily Northwestern: Northwestern University
Daily O\’Collegian: Oklahoma State University
Daily O’Collegian: Oklahoma State University
Daily Princetonian: Princeton University
Daily Skiff: Texas Christian University
Daily Targum: Rutgers University
Daily Trojan: University of Southern California
Daily Utah Chronicle: University of Utah
Dakota Student: University of North Dakota
Driftwood: University of New Orleans
East Carolinian: East Carolina University
East Tennessean: East Tennessee State University
El Vaquero: Glendale Community College
Emory Wheel: Emory University
Endicott Observer: Endicott College
Et Cetera: Eastfield College
Exponent: Montana State University
FSView & Florida Flambeau: Florida State University
Factory Times: SUNY Institute of Technology at Utica - Rome
Factory Times: SUNY Institute of Technology at Utica-Rome
Flat Hat: College of William and Mary
Foghorn: Del Mar College
Gannon Knight: Gannon University
Gator Times: University of Florida
Golden Gate Xpress: San Francisco State University
Hampden-Sydney Tiger: Hampden-Sydney College
Harvard Political Review: Harvard University
Herald: Arkansas State University
Highland Cavalier: University of Virginia - Wise
Hilltop News: St Edward’s University
Hilltop News: St. Edward’s University
Hilltop: Howard University
Horizons: Embry-Riddle Aeronautical University
Houstonian: Sam Houston State University
Idaho Argonaut: University of Idaho
Independent Collegian: University of Toledo
Independent Collegian: University of Toledo 
Independent Florida Alligator: University of Florida
Indiana Daily Student: Indiana University
Indiana Statesman: Indiana State University
Inside Vandy: Vanderbilt University
Ka La: Honolulu Community College
Ka Lee O Hawaii: University of Hawaii-Manoa
Kingsman: Brooklyn College
Knight News: Queens College
La Voz Weekly: De Anza College
Lion’s Roar: Southeastern Louisiana University
Loquitur: Cabrini College
Maroon Weekly: Texas A & M University
Mars’ Hill: Trinity Western University
Massachusetts Daily Collegian: University of Massachusetts - Amherst
Meridian: Lehman College
Mesa Legend: Mesa Community College
Miami Student: Miami University
Michigan Daily: University of Michigan-Ann Arbor
Michigan Independent: University of Michigan - Ann Arbor
Michigan Tech Lode: Michigan Tech University
Minnesota Daily: University of Minnesota
Mirror News: Henry Ford Community College
Montana Kaimin: University of Montana
Mustang News: Polytechnic State University
NECC Observer: Northern Essex Community College
New City Collegian: Seattle Central Community College
Northern Student: Bemidji State University
Northwestern Missourian: Northwest Missouri State University
Oak Leaf: Santa Rosa Junior College
Oklahoma Daily: University of Oklahoma Norman Campus
Old Gold and Black: Wake Forest University
Pacific Index: Pacific University
Pipe Dream: SUNY at Binghamton
Pointer View: United States Military Academy at West Point
Pueblo Today: Colorado State University - Pueblo
Reflector: Mississippi State University
Richland Chronicle: Richland College
Rocky Mountain Collegian: Colorado State University
Seawanhaka: Long Island University - Brooklyn Campus
Siena Heights Spectra: Siena Heights University
Six Mile Post: Georgia Highlands College
Sonoma State Star: Sonoma State University
Sounds Newspaper: South Puget Sound Community College
Southern Digest: Southern University-Baton Rouge
Spartan Daily: San Jose State University
State Times: SUNY College at Oneonta
Stillman Advance: Stillman College
Student Vanguard: Community College of Philadelphia
Suffolk Voice: Suffolk University
Swarthmore Phoenix: Swarthmore College
Talon Marks: Cerritos College
Tech News: Worcester Polytechnic Institute
TechNews: Illinois Institute of Technology
Temple News: Temple University
The Acorn: Drew University
The Albany Student Press: SUNY at Albany
The Alestle: Southern Illinois University - Edwardsville
The All State: Austin Peay State University
The Almanian: Alma College
The Aquinas: University of Scranton
The Argus: Illinois Wesleyan University
The Athenaeum: Acadia University
The Augsburg Echo: Augsburg College
The Avion: Embry-Riddle University
The BG News: Bowling Green State University
The Bates Student: Bates College
The Battalion: Texas A & M University
The Beacon: Palm Beach Atlantic University
The Beacon: Wilkes University
The Bear Facts: Pikeville College
The Bell Ringer: Augusta State University
The Bell Tower: Freed-Hardeman University
The Bennett Banner: Bennett College
The Bi-College News: Haverford College/Bryn Mawr College
The Bi-College News: Haverford and Bryn Mawr Colleges
The Bison: Harding University
The Blue & White Flash: Jackson State University
The Blue Banner: University of North Carolina - Asheville
The Blue Stocking: Presbyterian College
The Bottom Line: Frostburg State University
The Bradley Scout: Bradley University
The Branding Iron: University of Wyoming
The Bray: Southern Arkansas University - Magnolia
The Breeze: James Madison University
The Broadside: Central Oregon Community College
The Brown Daily Herald: Brown University
The Brunswickan: University of New Brunswick
The Buff and Blue: Gallaudet University
The Bullet: Mary Washington
The Bulletin: Emporia State University
The Butler Collegian: Butler University
The CNM Chronicle: Central New Mexico Community College
The California Aggie: University of California - Davis
The California Aggie: University of California, Davis
The Campanil: Mills College
The Campus Chronicle: Alcorn State University
The Campus Ledger: Johnson County Community College
The Campus Voice Online: Florida Community College at Jacksonville
The Campus: Allegheny College
The Campus: City College of New York
The Capaha Arrow: Southeast Missouri State University
The Carletonian: Carleton College
The Carroll News: John Carroll University
The Catalyst: Colorado College
The Centre College Cento: Centre College
The Charger: University of Alabama in Huntsville
The Chronicle
The Chronicle: College of Lake County
The Chronicle: Hofstra University
The Chronicle: Purdue University-Calumet
The Chronicle: Quinnipiac University
The Circle: Marist College
The Clackamas Print: Clackamas Community College
The Clarion: Madison Area Technical College
The Clause: Azusa Pacific University
The Cobbler: William Carey University
The College Hill: Sussex County Community College
The College Voice: Connecticut College
The Collegian: California State University - Fresno
The Collegian: Georgia Perimeter College
The Collegian: University of Richmond
The Collegian: University of Tulsa
The Collegio: Pittsburg State University
The Colonnade: Georgia College and State University
The Columbia Chronicle
The Columbia Chronicle: Columbia College
The Columbia Spectator: Columbia University
The Columbian: Columbia College
The Comenian: Moravian College
The Commentator: Yeshiva University
The Communicator: Chattanooga State Technical Community College
The Communicator: Spokane Falls Community College
The Commuter: Linn-Benton Community College
The Concordian: Concord College
The Courier: College of DuPage
The Courier: Monmouth University
The Creightonian: Creighton University - The Creightonian
The Crestiad: Cedar Crest College
The Crimson White: University of Alabama
The Criterion: Mesa State College
The Critic: Lyndon State College
The Crown: Redeemer University College
The Crow’s Nest: University of South Florida - St. Petersburg
The Crusader: College of the Holy Cross
The Current: Nova Southeastern University
The Current: University of Missouri - St. Louis
The Daily Athenaeum: West Virginia University
The Daily Aztec: San Diego State University
The Daily Barometer: Oregon State University
The Daily Campus: University of Connecticut
The Daily Cardinal: University of Wisconsin - Madison
The Daily Cougar: University of Houston
The Daily Egyptian: Southern Illinois University
The Daily Egyptian: Southern Illinois University, Carbondale
The Daily Emerald: University of Oregon
The Daily Free Press: Boston University
The Daily Gamecock: University of South Carolina - Columbia
The Daily Iowan: University of Iowa
The Daily Kent Stater: Kent State University
The Daily Texan: University of Texas - Austin
The Daily Titan: California State University - Fullerton
The Daily Toreador: Texas Tech University
The Daily Universe: Brigham Young University
The Daily Utah Chronicle: University of Utah
The Daily Vidette: Illinois State University
The Daily: Ball State University
The Dartmouth: Dartmouth College
The Defender: St MichaelÃfÂ¢Ã¢â(EURO)sÂ¬Ã¢â(EURO)zÂ¢s College
The Defender: St Michael’s College
The Delta Statement: Delta State University
The Denisonian: Denison University
The Depaulia: DePaul University
The Depauw: Depauw University
The Dickinsonian: Dickinson College
The District Chronicles: Howard University
The Duke Chronicle: Duke University
The Dynamo: Mount Union College
The Eagle Eye: Lock Haven University
The Eagle: American University
The Eagle: Florida Gulf Coast University
The Easterner: Eastern Washington University
The Echo: Western Connecticut State University
The Edge: University of Alaska Anchorage
The Elm: Washington College
The Equinox: Keene State College
The Etownian: Elizabethtown College
The Exponent: University of Wisconsin - Platteville
The Falcon Times: Miami-Dade Community College - North Campus
The Falcon: Seattle Pacific University
The Famuan: Florida Agricultural and Mechanical University
The Flor-Ala: University of North Alabama
The Flyer News: University of Dayton
The Foghorn: University of San Francisco
The Forum: Piedmont Virginia Community College
The Forum: Westminster College
The Fourth Estate: University of Wisconsin - Green Bay
The Gatepost: Framingham State College
The Gateway: University of Nebraska at Omaha
The George-Anne: Georgia Southern University
The Georgetown Voice: Georgetown University
The Georgia State University: Georgia State University
The Good 5 Cent Cigar: University of Rhode Island
The Greyhound: Loyola College - Maryland
The Griffen: Canisius College
The Griffon News: Missouri Western State College
The Grizzly: Ursinus College
The Guardian: University of California - San Diego
The Guardsman: City College of San Francisco
The Gulfordian: Guilford College
The Gustavian Weekly: Gustavus Adolphus College
The Harvard Crimson: Harvard University
The Hatchet: George Washington University
The Hawk: Saint Joseph’s University
The Hawkeye: University of Louisiana - Monroe
The Hawk’s Herald: Roger Williams University
The Heights: Boston College
The Herald: Hobart and William Smith Colleges
The Highlander: University of California - Riverside
The Hillsdale Collegian: Hillsdale College
The Holcad: Westminster College
The Horizon: Indiana University Southeast
The Hoya: Georgetown University
The ISU Bengal: Idaho State University
The Informer: University of Hartford
The Ionian: Iona College
The Iowa State Daily: Iowa State University
The J-TAC: Tarleton State University
The Jambar: Youngstown State University
The Johns Hopkins News-Letter: Johns Hopkins University
The Journal: University of Illinois - Springfield
The Journal: Webster University
The Justice: Brandeis University
The Kaleidoscope: University of Alabama at Birmingham
The Kansas State Collegian: Kansas State University
The Kentucky Kernel: University of Kentucky
The Kenyon Collegian: Kenyon College
The Knox Student: Knox College
The Lafayette: Lafayette College
The Lakeland College Mirror: Lakeland College
The Lamp: Lincoln Land Community College
The Lamron: SUNY at Geneseo
The Lance: University of Windsor
The Lanthorn: Grand Valley State University
The Lariat: Baylor University
The Lawrentian: Lawrence University
The Leader: Elmhurst College
The Leader: SUNY at Fredonia
The Linfield Review: Linfield College
The Lion’s Pride: Saint Leo University
The Longview Current: Longview Community College
The Louisville Cardinal: University of Louisville
The Mace & Crown: Old Dominion University
The Main Campus: University of Maine
The Maneater: University of Missouri - Columbia
The Manitou Messenger: St Olaf College
The Maroon Tiger: Morehouse College
The Maroon: Loyola University - New Orleans
The Marquette Tribune: Marquette University
The Mass Media: University of Massachusetts - Boston
The McGill Tribune: McGill University
The Megaphone: Southwestern University
The Mesa Press: San Diego Mesa College
The Miami Hurricane: University of Miami
The Michigan Journal: University of Michigan - Dearborn
The Michigan Review: University of Michigan - Ann Arbor
The Middlebury Campus: Middlebury College
The Minaret: University of Tampa
The Mirror: Fairfield University
The Miscellany News: Vassar College
The Montgomery Advocate: Montgomery College
The Mustang: Western New Mexico University
The Navigator: Jacksonville University
The Nevada Sagebrush: University of Nevada - Reno
The New Hampshire: University of New Hampshire
The New Voice: University of North Carolina - Charlotte
The News: Murray State University
The Niagara Index: Niagara University
The Nicholls Worth: Nicholls State University
The North Park Press: North Park University
The North Wind: Northern Michigan University
The Northeastern: Northeastern State University
The Northern Iowan: University of Northern Iowa
The Northern Light: University of Alaska Anchorage
The Northern Star: Northern Illinois University
The Northerner: Northern Kentucky University
The Nubian Message: North Carolina State University
The Nubian Message: North Carolina State University 
The Nubian Message: North Carolina State UniversityÃ,Â 
The Oakland Post: Oakland University
The Oberlin Review: Oberlin College
The Observer: Case Western Reserve University
The Observer: University of Notre Dame
The Observer: Yeshiva University
The Optimist: Abilene Christian University
The Oracle
The Oracle: Oral Roberts University
The Oracle: SUNY College at New Paltz
The Oracle: University of South Florida
The Orion: California State University - Chico
The Ottawa Campus: Ottawa University
The Outlook: Monmouth University
The Owens Outlook: Owens Community College
The Pace Press: Pace University
The Pacifican: University of the Pacific
The Paladin: Furman University
The Pan American: University of Texas - Pan American
The Pan American: University of Texas-Pan American
The Panther: Chapman University
The Parthenon: Marshall University
The Patriot: Francis Marion University
The Peace Times: Peace College
The Peak: Simon Fraser
The Pitt News: University of Pittsburgh - Pittsburgh Campus
The Pitt News: University of Pittsburgh-Pittsburgh Campus
The Plainsman: Auburn University
The Point News: St. Mary’s College of Maryland
The Poly Post: California State Polytechnic University - Pomona
The Post: Ohio University
The Prairie: West Texas A & M University
The Prodigy: University of California - Merced
The Profile: Agnes Scott College
The Prospector: Yuba College
The Pulse: Finch University of Health Sciences
The Quad: West Chester University
The Quindecim: Goucher College
The Racquet: University of Wisconsin - LaCrosse
The Rambler: Texas Wesleyan University
The Rampage: Bluefield College
The Ranger News: University of Wisconsin - Parkside
The Ranger: San Antonio College
The Rebel Yell: University of Nevada - Las Vegas
The Record: Buffalo State University
The Recorder: Central Connecticut University
The Rensselaer Polytechnic: Rensselaer Polytechnic Institute
The Reporter: Stetson University
The Retriever Weekly: University of Maryland - Baltimore County
The Reveille: Louisiana State University
The Ring-tum Phi: Washington and Lee University
The Rocket: Slippery Rock University
The Rutgers Observer: Rutgers University - Newark
The SNU Echo: Southern Nazarene University
The Sandspur: Rollins College
The Santa Clara: Santa Clara University
The Scarlet and Black: Grinnell College
The Scarlet: Clark University
The Scribe: University of Colorado at Colorado Springs
The Scroll: Brigham Young University-Idaho
The Seahawk: University of North Carolina Wilmington
The Sentry: Robert Morris University
The Setonian: Seton Hall University
The Shorthorn: University of Texas - Arlington
The Shorthorn: University of Texas-Arlington
The Sidelines: Middle Tennessee State University
The Signal: California State University - Stanislaus
The Signal: College of New Jersey
The Simpsonian: Simpson College
The Slate: Shippensburg University
The Snapper: Millersville University
The Snowdrift: Snow College
The Sojourn: Indiana Wesleyan University
The South End: Wayne State University
The South Texan: Texas A & M University - Kingsville
The Southern: Florida Southern College
The Spectator: Hamilton College
The Spectator: Seattle University
The Spectator: University of Wisconsin - Eau Claire
The Spectrum: Sacred Heart University
The Spinnaker: University of North Florida
The Spur: Southwest State University
The Stampede: Milligan College
The Stanford Daily: Stanford University
The State Hornet: California State University - Sacramento
The State Press: Arizona State University
The Stormy Petrel: Oglethorpe University
The Stoutonia: University of Wisconsin - Stout
The Student Life: Pomona College
The Student Life: Washington University - St. Louis
The Student Printz: University of Southern Misissippi
The Stute: Stevens Institute of Technology
The Sun Star: University of Alaska Fairbanks
The Tack: Buena Vista University
The Tartan: Carnegie Mellon University
The Tartan: Radford University
The Tech: Massachusetts Institute of Technology
The Technician: North Carolina State University
The Technique: Georgia Tech
The Ticker: Baruch College
The Tiger: Clemson University
The Tor Echo: Alfred State College
The Torch: Roosevelt University
The Torch: Valparaiso University
The Tower: Catholic University of America
The Towerlight: Towson University
The Towers: Worcester Polytechnic Institute
The Trail: University of Puget Sound
The Trailblazer Times: MidAmerica Nazarene University
The Triangle: Drexel University
The Tripod: Trinity College
The Troubadour: Franciscan University - Steubenville
The Trumpet: West Liberty State College
The UALR Forum: University of Arkansas Main Campus
The UTD Mercury: University of Texas - Dallas
The UTD Mercury: University of Texas-Dallas
The Union: El Camino College
The University Leader: Fort Hays State University
The University News: Saint Louis University
The University Star: Texas State University - San Marcos
The University Times: Trinity College
The Utah Statesman: Utah State University
The Valencia Source: Valencia Community College
The Valley Vanguard: Saginaw Valley State University
The Vanguard: Univeristy of South Alabama
The Vantage: Newman University
The Vermilion: University of Louisiana-Lafayette
The Vessel: University of Sioux Falls
The Vie Collegienne: Lebanon Valley College
The Viking News: Westchester Community College
The Villanovan: Villanova University
The Vista: University of Central Oklahoma
The Vista: University of San Diego
The Voice: Bloomsburg University
The Voice: Glendale Community College
The Volunteer: John A. Logan College
The Voyager: University of West Florida
The Washburn Review: Washburn University
The Wesleyan Argus: Wesleyan University
The Whit: Rowan University
The Whitman College Pioneer: Whitman College
The Yale Herald: Yale University
Tufts Daily: Tufts University
UCD Advocate: University of Colorado Denver
UMD Statesman: University of Minnesota - Duluth
UNC Mirror: University of Northern Colorado
Uloop.com
University Chronicle: St Cloud State University
University News: University of Missouri - Kansas City
University Press: Lamar University
University Times: California State University - Los Angeles
Vermont Cynic: University of Vermont
WUEV-FM: University of Evansville
WUTM-FM: University of Tennessee - Martin
Wartburg Trumpet: Wartburg College
Washington Square News: New York University
Wellesley News: Wellesley College
Western Courier: Western Illinois University
Western Oregon Journal: Western Oregon University
the Inkwell: Armstrong Atlantic State University